득점,경기,승,패,무,승률,Season
0,1,0,1,0,0.0,2018
1,8,0,8,0,0.0,2018
2,6,0,6,0,0.0,2018
3,13,7,6,0,0.538,2018
4,11,3,8,0,0.273,2018
5,20,12,8,0,0.6,2018
6,26,20,6,0,0.769,2018
7,16,12,4,0,0.75,2018
8,7,6,1,0,0.857,2018
9,8,8,0,0,1.0,2018
10,5,5,0,0,1.0,2018
11,6,4,2,0,0.667,2018
12,3,3,0,0,1.0,2018
13,9,9,0,0,1.0,2018
14,3,2,1,0,0.667,2018
17,2,2,0,0,1.0,2018
