득점,경기,승,패,무,승률,Season
0,4,0,4,0,0.0,2015
1,10,1,9,0,0.1,2015
2,13,2,11,0,0.154,2015
3,14,4,10,0,0.286,2015
4,19,7,12,0,0.368,2015
5,18,10,8,0,0.556,2015
6,18,12,6,0,0.667,2015
7,12,9,3,0,0.75,2015
8,6,4,2,0,0.667,2015
9,13,13,0,0,1.0,2015
10,7,7,0,0,1.0,2015
11,2,2,0,0,1.0,2015
12,2,2,0,0,1.0,2015
13,1,1,0,0,1.0,2015
14,2,2,0,0,1.0,2015
15,1,1,0,0,1.0,2015
16,1,1,0,0,1.0,2015
18,1,1,0,0,1.0,2015
