실점,경기,승,패,무,승률,Season
0,10,10,0,0,1.0,2015
1,12,12,0,0,1.0,2015
2,12,10,2,0,0.833,2015
3,17,15,2,0,0.882,2015
4,19,13,6,0,0.684,2015
5,18,9,9,0,0.5,2015
6,10,4,6,0,0.4,2015
7,10,4,6,0,0.4,2015
8,8,0,8,0,0.0,2015
9,7,1,6,0,0.143,2015
10,8,1,7,0,0.125,2015
11,3,0,3,0,0.0,2015
12,3,0,3,0,0.0,2015
13,1,0,1,0,0.0,2015
14,1,0,1,0,0.0,2015
15,1,0,1,0,0.0,2015
16,1,0,1,0,0.0,2015
17,2,0,2,0,0.0,2015
25,1,0,1,0,0.0,2015
